0, 0, 0, 0, 0, 0, 0, 0, 5, 5, 5, 5, 5, 5, 5, 5, 5, 5, 5, 5, 5, 0
0, 0, 0, 0, 0, 0, 0, 3, 1, 1, 1, 1, 1, 1, 1, 1, 1, 1, 1, 1, 1, 4
0, 0, 0, 0, 0, 0, 0, 3, 1, 4, 6, 6, 6, 6, 6, 6, 6, 6, 6, 6, 6, 0
0, 0, 0, 0, 0, 0, 5, 3, 1, 4, 0, 0, 0, 0, 0, 0, 0, 0, 0, 0, 0, 0
0, 0, 0, 5, 5, 3, 1, 1, 1, 1, 5, 5, 5, 5, 5, 5, 5, 5, 0, 0, 0, 0
0, 5, 5, 1, 1, 9, 1, 1, 1, 1, 1, 1, 1, 1, 1, 1, 1, 1, 4, 5, 5, 0
0, 7, 1, 1, 6, 6, 6, 6, 6, 6, 6, 6, 6, 6, 6, 6, 3, 1, 1, 1, 1, 4
0, 0, 0, 0, 0, 0, 0, 0, 0, 0, 0, 0, 0, 0, 0, 0, 0, 6, 6, 6, 6, 0
0, 0, 0, 0, 0, 0, 0, 0, 0, 0, 0, 0, 0, 0, 0, 0, 0, 0, 0, 0, 0, 0