0, 0, 0, 0, 0, 0, 0, 0, 0, 0, 0, 0, 0, 0, 0, 0
0, 0, 0, 0, 0, 0, 0, 0, 0, 0, 0, 0, 0, 0, 5, 0
0, 1, 1, 1, 5, 5, 5, 5, 5, 5, 5, 5, 5, 5, 1, 4
0, 6, 6, 1, 1, 1, 1, 1, 1, 1, 1, 1, 1, 1, 1, 4
0, 0, 0, 6, 6, 3, 1, 1, 1, 1, 6, 6, 6, 6, 6, 0
0, 0, 0, 0, 0, 0, 6, 3, 1, 4, 0, 0, 0, 0, 0, 0
0, 0, 0, 0, 0, 0, 0, 3, 1, 4, 5, 5, 5, 5, 5, 0
0, 0, 0, 0, 0, 0, 0, 3, 1, 1, 1, 1, 1, 1, 1, 4
0, 0, 0, 0, 0, 0, 0, 0, 6, 6, 6, 6, 6, 6, 6, 0
